0000000000000000000000000000000000000000000000000000000000000000000000000000000000000000000000000000
0000000000000000000000000000000000000000000000000000000000000000000000000000000000000000000000000000
0001111111111111111111110000001111111110000000000000000000000000000000000000000111111111111111111110
0001111111111111111111110000001111111110000000000000000000000000000000000000000111111111111111111110
0001111111111111111111110000001111111110000000011111100000000000000000000000000111111111111111111110
0001111111111111111111110000001111111110000000011111100000000111111111111100000111111111111111111110
0001111111111111111111110000001111111110000000011111100000000111111111111100000111111111111111111110
0001111111111111111111110000001111111110000000011111100000000111111111111100000111111111111111111110
0001111111111111111111110000001111111110000000011111100000000111111111111100000111111111111111111110
0001111111111111111111110000001111111110000000011111100000000111111111111100000111111111111111111110
0001111111111111111111110000001111111110000000000002000000000111111111111100000111111111111111111110
0001111111111111111111112222221111111112222222222222000000000111111111111100000111111111111111111110
0001111111111111111111110000201111111110000000000002000000000000020000000000000000000002000000000000
0001111111111111111111110000201111111110000000000002000000000000020000000000000000000002000000000000
0001111111111111111111110000201111111110000000000002000000000000022222222222111111111111111100000000
0001111111111111111111110000201111111110000000000111111000001111111111000000111111111111111100000000
0001111111111111111111110000201111111110000000000111111000001111111111000000111111111111111100000000
0000000000000000000000000000201111111110000000000111111000001111111111000000111111111111111100000000
0000000000000000000000000000201111111110000000000111111000001111111111000000111111111111111100000000
0000000000000000000000000000201111111110000000000111111000001111111111000000111111111111111100000000
0000000000000000000000000000201111111110000000000111111000001111111111000000111111111111111100000000
0000000000000000000000000000201111111110000000000111111000001111111111000000111111111111111100000000
0000000000000000000000000000200000000000000000000000000000001111111111000000111111111111111100000000
0000000000000000000000000000200000000000000000000000000000001111111111000000111111111111111100000000
0000000000000000000000000000200000000000000000000000000000001111111111000000002000000000000000000000
0000000000000000000000000111111111111111000000000000000000001111111111000000002000000000000000000000
0000000000000000000000000111111111111111222222222222222222221111111111222222222000000000000000000000
0001111111111111111110000111111111111111000000000020000000000000000000000000002000000000000000000000
0001111111111111111110000111111111111111000000000020000000000000000000000000002000000000000000000000
0001111111111111111110000111111111111111000000000020000000000000000000000000002000000000000000000000
0001111111111111111110000111111111111111200000000020000000000000000000000000002000000000000000000000
0001111111111111111110000111111111111111200000000020000000011111100000000000002000000000000000000000
0001111111111111111110000111111111111111200000000020000000011111100000000000002000111111111111000000
0001111111111111111110000111111111111111200000000020000000011111100000000000002000111111111111000000
0001111111111111111110000000200000000000200000000020000000011111100000000000002000111111111111000000
0001111111111111111110000000200000000000200000000020000000011111100000011111102000111111111111000000
0000000000002000000000000000200000000000200000000020000000011111100000011111102000111111111111000000
0000000000002000000000000000200000000000200000000020000000011111100000011111102000111111111111000000
0000001111111111112222222222222222222222200000000020000000011111100000011111102000111111111111000000
0000001111111111110000000000000000000000200000000020000000011111100000011111102000111111111111000000
0000001111111111110000000000000000000000200000000020000000011111122222211111122222111111111111000000
0000001111111111110000000000000000000111111111111111100000011111100000011111100000111111111111000000
0000001111111111110000000000000000000111111111111111100000000020000000011111100000111111111111000000
0000001111111111110000000000000000000111111111111111100000000020000000011111100000111111111111000000
0000001111111111110000000000000000000111111111111111100000000020000000011111100000111111111111000000
0000001111111111110000000000000000000111111111111111100000000020000000011111100000111111111111000000
0000001111111111110000000000000000000111111111111111100000011111111100011111100000111111111111000000
0000001111111111110000000000000000000111111111111111100000011111111100011111100000111111111111000000
0000001111111111110000000000000000000111111111111111100000011111111100011111100000111111111111000000
0000001111111111110000000000000000000111111111111111100000011111111100011111100000111111111111000000
0000000000000000000000000000000000000111111111111111100000000000000000000000000000111111111111000000
0000000000000000000000000000000000000000000000000020000000000000000000000000000000000000000000000000
0000000000000000000000000000000000000000000000000020000000000000000000000000000000000000000000000000
0000000000000000000000000000000000000000000000000020000000000000000000000000000000000000000000000000
0000000000000000000000000000000000000000000000000020000000000000000000000000000011111100000001111110
0000000000000000000000000000000000000000000000000020000000000000000000000000000011111100000001111110
0000000000000000000000000000000000000000111111100020000000000000000000000000000011111100000001111110
0000011111111111111111100000000000000000111111100020000000000000000000000000000011111122222221111110
0000011111111111111111100000000000000000111111100011111111111111111111111110000011111100020001111110
0000011111111111111111100000000000000000111111100011111111111111111111111110000011111100020001111110
0000011111111111111111100000000000000000111111100011111111111111111111111110000000000000020000000000
0000011111111111111111100000000000000000111111100011111111111111111111111110000000000000020000000000
0000011111111111111111100001111111111000111111100011111111111111111111111110000000000000020000000000
0000011111111111111111100001111111111000111111122211111111111111111111111110000000000000111111100000
0000011111111111111111100001111111111000111111100011111111111111111111111110000000000000111111100000
0000011111111111111111122221111111111000111111100011111111111111111111111110000000000000111111100000
0000011111111111111111100001111111111000111111100011111111111111111111111110000111111122111111100000
0000011111111111111111100001111111111000111111100011111111111111111111111110000111111100111111100000
0000011111111111111111100001111111111000000000000011111111111111111111111110000111111100111111100000
0000011111111111111111100001111111111000000000000011111111111111111111111110000111111100020000000000
0000011111111111111111100001111111111000000000000011111111111111111111111110000000000000020000000000
0000011111111111111111100001111111111000000000000020000000200000000000000000000000000000020000000000
0000011111111111111111100001111111111000000000000020000000200000000000000000000000000000020000000000
0000000000000000000200000000000000000000000000000020000000200000000000000000000000000000020000000000
0000000000000000000200000000000000000000000000000020000000200000000111111111000000000000020000000000
0000000000000000000200000000000000000000000000000020000000200000000111111111000000000000020000000000
0000000000000000000222222222222222222222222222111111111111111222222111111111222222222222220000011110
0000000000000000000200000000000000000000000000111111111111111000000111111111000000000000020000011110
0000000000000000000200000000000000000000000000111111111111111000000111111111000011111111111112211110
0000000000000000000200000000000000000000000000111111111111111000000111111111000011111111111110011110
0000000011111111111110000000000000000000000000111111111111111000000111111111000011111111111110011110
0000000011111111111110000000000000000000000000111111111111111000000111111111000011111111111110011110
0000000011111111111110000000000000000000000000111111111111111000000111111111000011111111111110011110
0000000011111111111110000000000000000000000000111111111111111000000111111111000011111111111110011110
0000000011111111111110000000000000000000000000111111111111111000000111111111000000000000020000011110
0000000011111111111110000000000000000000000000111111111111111000000111111111000000000000020000000000
0000000011111111111110000111111111111100000000111111111111111222222111111111000000000000020000000000
0000000011111111111110000111111111111100000000111111111111111000000111111111000000000000020000000000
0000000011111111111110000111111111111100000000111111111111111000000000000000000000000000020000000000
0000000011111111111112222111111111111100000000111111111111111000000000000000000011111111120000000000
0000000011111111111110000111111111111100000000111111111111111000000000000000000011111111120000000000
0000000011111111111110000111111111111100000000000000000000000000000000000000000011111111120000000000
0000000011111111111110000111111111111100000000000000000000000000000000000000000011111111120000000000
0000000011111111111110000111111111111100000000000000000000000000000000000000000011111111122211111110
0000000011111111111110000111111111111100000000000000000000000000000000000000000011111111100011111110
0000000011111111111110000111111111111100000000000000000000000000000000000000000011111111100011111110
0000000011111111111110000111111111111100000000000000000000000000000000000000000011111111100011111110
0000000000000000000000000111111111111100000000000000000000000000000000000000000000000000000011111110
0000000000000000000000000000000000000000000000000000000000000000000000000000000000000000000011111110
0000000000000000000000000000000000000000000000000000000000000000000000000000000000000000000000000000
