0000000000000000000000000000000000000000000000000000000000000000000000000000000000000000000000000000
0011111111111111111000000000000001111111111110000000000000000000000000000000000000000000000000000000
0011111111111111111000000000000001111111111110000000000000000000000000000000000000000000000000000000
0011111111111111111000000000000001111111111110001110000000000001111111000000000000000000000000000000
0011111111111111111000000000000001111111111110001110011111110001111111000000000000000000000000000000
0011111111111111111000000000000001111111111112221110011111110001111111000000111111111111111000111110
0011111111111111111000000000000001111111111110001110011111110001111111000000111111111111111000111110
0011111111111111111000000000000001111111111110001110011111112221111111000000111111111111111000111110
0011111111111111111000000000000000000020000000001110011111110201111111000000111111111111111222111110
0000000000002000000000000000000000000020000000001110011111110200000000000000111111111111111000111110
0000000000002000000000000000000000000020000000000000011111110200000000000000111111111111111000111110
0000000000002000000000000000000000000020000000000000011111110200000000000000111111111111111000111110
0000000000002000000000000000000001111111111111111000011111110200000000000000111111111111111000111110
0000001111111111111100000000000001111111111111111000000000000200000000000000111111111111111000111110
0000001111111111111100000000000001111111111111111000000000000200000000000000000000000200000000111110
0000001111111111111100000000000001111111111111111000000000000200000000000000000000000200000000000000
0000001111111111111100000000000001111111111111111000000000000200000000000000000000000200000000000000
0000001111111111111100000000000001111111111111111000000000000200000000000000000000000200000000000000
0000001111111111111100000000000001111111111111111000000000111111111110000000000000000200000000000000
0000001111111111111100000000000001111111111111111000000000111111111110001111111100000200000000000000
0000001111111111111122222222222221111111111111111222222222111111111112221111111122222200000000000000
0000001111111111111100000000000000000020000000000020000000111111111110001111111100000200000000000000
0000001111111111111100000000000000000020000000000020000000111111111110001111111100000211111111110000
0000000000002000000000000000000000000020000000000020000000111111111110001111111100000211111111110000
0000000000002000000000000000000000000020000000000020000000000200000000001111111100000211111111110000
0000000000002000000000000000000000000020000000000020000000000200000000001111111100000211111111110000
0000000000002000000000000000000000000020000000000020000000001111111100001111111100000211111111110000
0000000000002000000000000000000000000020000000000020000000001111111100001111111100000211111111110000
0000000000002000000000000001111111111111111100000020000000001111111100001111111122222211111111110000
0000000000002000000000000001111111111111111100000020000000001111111100001111111100000011111111110000
0000000000002000000000000001111111111111111100000020000000001111111100001111111100000011111111110000
0000000000111111111111110001111111111111111100000020000000001111111100001111111100000011111111110000
0111100000111111111111110001111111111111111100000020000000001111111100000000000000000011111111110000
0111100000111111111111110001111111111111111100000020000000001111111100000000000000000011111111110000
0111100000111111111111110001111111111111111100000020000000001111111100000000000000000011111111110000
0111122222111111111111110001111111111111111100000020000000001111111100000000000000000000000000000000
0111100000111111111111110001111111111111111100000020000000001111111100000000000000000000000000000000
0111100000111111111111110001111111111111111100000020000000000000000000000000000000000000000000000000
0000000000000000000000000001111111111111111100000020000000000000000000000000000000000000000000000000
0000000000000000000000000000000000000000000000000020000000000000000000000000000000000000000000000000
0000000000000000000000000000000000000000000000000020000000000000000000000000000000000000000000000000
0000000000000000111111000000000000000000000000000020000000000000000000000000000000000000000000000000
0000000001111100111111000000000000000000000000000020000000000000000000000000011111111111111100000000
0111110001111100111111000000000000000000000000000020000000000000000000000000011111111111111100000000
0111110001111100000200000000000000000000000000000020000000000000000000000000011111111111111100000000
0111112221111122222200000000000000000000000000000020000000000000000000000000011111111111111100000000
0111110001111100011111100011111111100000000000000020000000000000000000000000011111111111111100000000
0111110001111100011111100011111111100000000011111111110000000000000000000000011111111111111100000000
0111110000002000011111100011111111100000000011111111110000000000000000000000011111111111111100000000
0000000000002000011111100011111111100000000011111111110000000000000000000000011111111111111100000000
0000000000002000000000000011111111100000000011111111110000000000000000000000011111111111111100000000
0000000000002000000000000011111111100000000011111111110001111111111111100000011111111111111100000000
0000000000002001111111100011111111100000000011111111110001111111111111100000011111111111111100000000
0001111111111001111111100011111111100000000011111111110001111111111111100000011111111111111100000000
0001111111111001111111100011111111100000000011111111110001111111111111100000011111111111111100000000
0001111111111001111111100011111111100000000011111111110001111111111111100000011111111111111100000000
0001111111111221111111100011111111100000000011111111110001111111111111100000011111111111111100000000
0001111111111001111111100011111111100000000011111111110001111111111111100000011111111111111100000000
0001111111111001111111100011111111122222222211111111110001111111111111100000011111111111111100000000
0001111111111001111111100011111111100002000011111111110001111111111111100000011111111111111100000000
0000000000002000000000000011111111100002000011111111110001111111111111122222211111111111111100000000
0000000000002000000000000011111111100002000011111111110001111111111111100000011111111111111100000000
0000000000002000000000000011111111100002000011111111110001111111111111100000011111111111111100000000
0000000000002000000000000011111111100002000011111111110001111111111111100000011111111111111100000000
0000000000002000000000000000000000000002000011111111110001111111111111100000011111111111111100000000
0000000000002000000000000000000000000002000011111111110001111111111111100000011111111111111100000000
0000000000002000000000000000000000000002000011111111110001111111111111100000020000000000000000000000
0000000000002000000000000000000000000002000011111111110001111111111111100000020000000000000000000000
0000000000002000000000000000000000000002000011111111110001111111111111100000020000000000000000000000
0000000000002000000000000000000000000002000000000020000001111111111111100000020000000000000000000000
0111111111111111111112222222222222222222222222222222222221111111111111122222220000000000000000000000
0111111111111111111110000000000000000002000000000000000001111111111111100000020000000000000000000000
0111111111111111111110000000000000000002000000000000000001111111111111100000020000000000000000000000
0111111111111111111110000000000000000002000000000000000001111111111111100000020000000000000000000000
0111111111111111111110000000000000000002000000000000000001111111111111100000020000000000000000000000
0111111111111111111110000000000000000002000000000000000001111111111111100000020000000000000000000000
0111111111111111111110000000000000000002000000000000000001111111111111100000020000000000000000000000
0111111111111111111110000000000000000002000000000000000001111111111111100000020000000000000000000000
0111111111111111111110000111111110000002000000000000000000000000000000000000020000000000000000000000
0111111111111111111110000111111110000002000000000000000000000000000000000000020000000000000000000000
0111111111111111111110000111111110011111111110000000000000000000000000000000020000000000000000000000
0000000000002000000000000111111110011111111110000000000000000000000000000000020000000000000000000000
0000000000002000000000000111111110011111111110000000000000000000000000000000020000000000000000000000
0000000000002000000000000111111110011111111110000000000000000000000000000000020000000000000000000000
0000000000002000000000000111111110011111111110000000000000000000000000000000020000000000000000000000
0000000000002000000000000111111110011111111110000000000000001111111111000000020000000000000000000000
0000000000002000000000000111111110011111111110000000000000001111111111000000011111111111111111111100
0011111111111000000000000111111110011111111110000000000000001111111111000000011111111111111111111100
0011111111111000000000000111111112211111111110000000000000001111111111000000011111111111111111111100
0011111111111000000000000111111110011111111110000000000000001111111111000000011111111111111111111100
0011111111111000000000000111111110011111111110000000000000001111111111222222211111111111111111111100
0011111111111000000000000111111110011111111110000000000000001111111111000000011111111111111111111100
0011111111111000000000000111111110011111111110000000000000001111111111000000011111111111111111111100
0011111111111000000000000111111110011111111110000000000000001111111111000000011111111111111111111100
0011111111111000000000000111111110011111111110000000000000001111111111000000011111111111111111111100
0011111111111000000000000111111110011111111110000000000000001111111111000000011111111111111111111100
0011111111111000000000000111111110011111111110000000000000001111111111000000000000000000000000000000
0011111111111000000000000111111110000000000000000000000000001111111111000000000000000000000000000000
0011111111111000000000000000000000000000000000000000000000000000000000000000000000000000000000000000
0000000000000000000000000000000000000000000000000000000000000000000000000000000000000000000000000000
