0000000000000000000000000000000000000000000000000000000000005555555550000000000000000000000000000000
0000000000000000000000000000000000000000000000000000000000031111111114000000000000000000000000000000
0005555555500000000000000000000000000000000000000000000000031111111114000555555555000000000000000000
0031111111140000005555555555555550000000000000005555555550031111111114003111111111400000000000000000
0031111111140000031111111111111114000000000000031111111114031111111114003111111111400000000000000000
0031111111140000031111111111111114000000000000031111111114031111111114003111111111400000000000000000
0031111111140000031111111111111114000000000000031111111114031111111114003111111111400000000000000000
0031111111140000031111111111111114000000000000031111111114031111111114003111111111400000000000000000
0031111111140000031111111111111114000000000000031111111114031111111114003111111111400000000000000000
0031111111140000031111111111111114000000000000031111111114031111111114003111111111400000000000000000
0031111111140000031111111111111114000000000000031111111114031111111114003111111111400005555555555550
0031111111140000031111111111111114000000000000031111111114031111111114003111111111400031111111111114
0031111111140000006666666663246660000000000000031111111115551111111115555111111111555551111111111114
0006663246600000000000000003240000000000000000031111111112221111111112222111111111222221111111111114
0000003245555555555555555553245555550000000000031111111116661111111116626111111111666661111111111114
0000003222222222222221111111111111114000000000031111111114031111111114324111111111400031111111111114
0000003246666666666661111111111111114000000000031111111114006666666660324111111111400031111111111114
0000003240000000000031111111111111114000000000031111111114000000000000324666666666000031111111111114
0000003240000000000031111111111111114000000000031111111114000000000000324000000000000031111111111114
0000553245500000000031111111111111114000000000006666666660000000000000324000000000000031111111111114
0003111111140000000031111111111111114000000000000000000000000000000000324000000000000031111111111114
0003111111140000000031111111111111114000000000000000000000000000000000324000000000000031111111111114
0003111111140000000031111111111111114000000000000000000000000000000000324000000000000031111111111114
0003111111140000000031111111111111114000000000000000000000000000000000324000000000000006666666666660
0003111111140000000031111111111111114000000000000000000000000000000000324000000000000000000000000000
0003111111140000000031111111111111114000000000000000000000000000000000324000000000000000000000000000
0003111111140000000032466666666666660000000000000000000000000000000000324000000000000000000000000000
0003111111140000000032400000000000000000000000000000000000000000000000324000000055555555555555550000
0003111111140000000032400000000000000000000000000000000000000000000000324000000311111111111111114000
0003111111140000000032400000000000000000000055555555555555555555555000324000000311111111111111114000
0000666666600000000032400000000000000000000311111111111111111111111400324000000311111111111111114000
0000000000000000000032400000000000000000000311111111111111111111111400324000000311111111111111114000
0000000000000000000032400000000000000000000311111111111111111111111400324000000311111111111111114000
0055555550000555555532455555555555555000000311111111111111111111111400324000000311111111111111114000
0311111114003111111111111111111111111400000311111111111111111111111400324000000311111111111111114000
0311111114003111111111111111111111111400000311111111111111111111111400324000000311111111111111114000
0311111114003111111111111111111111111400000311111111111111111111111400324000000311111111111111114000
0311111114003111111111111111111111111400000311111111111111111111111400324000000311111111111111114000
0311111115555111111111111111111111111400000311111111111111111111111400324000000311111111111111114000
0311111112222111111111111111111111111400000311111111111111111111111400324000000311111111111111114000
0311111116666111111111111111111111111400000311111111111111111111111400324000000311111111111111114000
0311111114003111111111111111111111111400000311111111111111111111111400324000000311111111111111114000
0311111114003111111111111111111111111400000311111111111111111111111400324000000311111111111111114000
0311111114003111111111111111111111111400000066666666663246666666666000324000000311111111111111114000
0311111114000666666632466666666666666000000000000000003240000000000000324000000311111111111111114000
0066666660000000000032400000000000000000000000000000003240000000000000324000000311111111111111114000
0000000000000000000032400000000000000000000000000000003240000000000000324000000311111111111111114000
0000000000000000000032400000000000000000000000000000003240000000000000324000000311111111111111114000
0000000000000000000032400000000000000000000000000000003245555555555555525555555511111111111111114000
0000000005555555555532455555555555555555555555555555553222222222222222222222222211111111111111114000
0000000031111111111112222222222111111112222111111111111111112222222222226666666611111111111111114000
0000000031111111111112466666666111111116666111111111111111116666666666324000000311111111111111114000
0000000031111111111112400000003111111114003111111111111111114000000000324000000066632466666666660000
0000000031111111111112400000003111111114003111111111111111114000000000324000000000032400000000000000
0000000031111111111112400000003111111114003111111111111111114000000000324000000000032400000000000000
0000000031111111111112400000003111111114003111111111111111114000000000324000000000032400000000000000
0000000031111111111112400000003111111114003111111111111111114000000000324000000000032400000000000000
0000000031111111111112555555555111111114003111111111111111114000000000324000555555532455555500000000
0000000031111111111112222222222111111114003111111111111111114000000000324003111111111111111140000000
0000000031111111111112666666666111111114003111111111111111114000000000324003111111111111111140000000
0000000031111111111112400000003111111114003111111111111111114000000000324003111111111111111140000000
0000000031111111111112400000003111111114003111111111111111114000000000324003111111111111111140000000
0000000006666666666632400000003111111114003111111111111111114000000000324003111111111111111140000000
0000000000000000000032400000003111111114003111111111111111114000000000324003111111111111111140000000
0000000000000000000032400000000666666660003111111111111111114000000000324003111111111111111140000000
0000000000000000000032400000000000000000003111111111111111114000000000324003111111111111111140000000
0000000000000000000032400000000000000000003111111111111111114000000000324003111111111111111140000000
0000000000000000000032400000000000000000003111111111111111114000000000324003111111111111111140000000
0000555555555550000032400000005555005555003111111111111111114000000000324003111111111111111140000000
0003111111111114000032455500031111431111400666666666666666660000000000324003111111111111111140000000
0003111111111114000311111140031111431111400000000000000000000000000000324003111111111111111140000000
0003111111111114000311111140031111431111400000000000000000000000000000324000666666666666666600000000
0003111111111114000311111140031111551111400000000000000000000000000000324005555555500005555555550000
0003111111111114000311111140031111221111400000000000000000005555555555324031111111140031111111114000
0003111111111115555511111140031111261111400000000000000000031111111111324031111111140031111111114000
0003111111111112222211111140031111241111400000000000000000031111111111324031111111140031111111114000
0003111111111116666611111140031111246666000000000000000000031111111111324031111111140031111111114000
0003111111111114000311111140031111240000000000000000000000031111111111324031111111140006666324660000
0000666666663240000311111140006663240000000000000000000000031111111111324031111111140055555324555500
0000000000003240000311111140000003240000000000000000000000031111111111324006632466600311111111111140
0000000000003240000311111140000003240000000000000000000000031111111111324000032400000311111111111140
0000000000003240000032466600000003240000000000000000000000031111111111324000032400000311111111111140
0000000000003240555532400000555553245555500000000000000000031111111111324000032400000311111111111140
0005555550003245111111155555111111111111140055555555550000031111111111324055532455550311111111111140
0031111114003222111111122222111111111111140311111111114000031111111111324311111111114066666324666600
0031111114003246111111166666111111111111140311111111115555551111111111525511111111115555555324000000
0031111114003243111111140003111111111111140311111111112222221111111111222211111111112222222224550000
0031111114003243111111140003111111111111140311111111116666661111111111666611111111116661111111114000
0031111114003243111111140003111111111111140311111111114000031111111111400311111111114031111111114000
0031111114003243111111140003111111111111140311111111114000031111111111400311111111114031111111114000
0031111115555255111111140000666663246666600311111111114000031111111111400311111111114031111111114000
0031111112222222111111140000000003240000000311111111114000031111111111400311111111114031111111114000
0031111116666666111111140000000003240000000311111111114000031111111111400066666666660006666324660000
0031111114000003111111140000555553245555000311111111114000031111111111400000000000000000000324000000
0031111114000003111111140003111111111111400311111111114000006666666666000000000000000005555324555000
0031111114000003111111140003111111111111400311111111114000000000000000000000000000000031111111111400
0031111114000003111111140003111111111111400311111111114000000000000000000000000000000031111111111400
0031111114000003111111140003111111111111400311111111114000000000000000000000000000000031111111111400
0006666660000003111111140003111111111111400311111111114000000000000000000000000000000031111111111400
0000000000000000666666600000666666666666000066666666660000000000000000000000000000000006666666666000
